the telly / the box / (US) the (boob) tube	la télé
the small screen	le petit écran
a television (set) / a TV set	un téléviseur
satellite TV / cable TV	la télé satellite / le câble
a dish	une antenne parabolique
digital terrestrial television / DTT	la télévision numérique terrestre / la TNT
high-definition television / HDTV	la télévision haute définition
to switch on / to switch off TV	allumer / éteindre la télé
to watch TV	regarder la télévision
a channel / a news channel	une chaîne / une chaîne d’infos
pay-per-view TV	la télévision à la carte
pay TV / a pay-TV channel	une chaîne payante
a scrambled programme	un programme crypté
a programme that is not scrambled	un programme en clair
a decoder	un décodeur
to channel hop / to zap channels / (US) to channel surf	zapper
a remote control	une télécommande
a viewer	un téléspectateur
to be broadcast live	être retransmis en direct
a live broadcast	une retransmission en direct
a prerecorded programme	une émission en différé
a rerun / a repeat	une rediffusion
a slot	un créneau horaire
prime time television	les heures de grande écoute
the 8 o’clock news	le journal de 20 heures
breaking news	les infos de dernière minute
infotainment	l’infospectacle
an anchorman / an anchorwoman	un présentateur / une présentatrice
a face-to-face TV debate	un débat télévisé
a TV series / a TV serial	une série / un feuilleton télévisé(e)
a soap opera	un soap opéra, un feuilleton
a documentary	un documentaire
reality TV	la téléréalité
to be on the air	être à l’antenne
the ratings	l’Audimat
to be addicted to TV	ne pas pouvoir se passer de la télé
a TV addict	un accro de la télé
