fair trade products	les produits issus du commerce équitable
fair trade food	les denrées alimentaires issues du commerce équitable
fair trade fruit	des fruits équitables
oranges / bananas / pineapples	des oranges / bananes / ananas
fair trade fruit juices	des jus de fruits équitables
coffee / tea	du café / du thé
chocolate / cocoa	du chocolat / du cacao
sugar	du sucre
honey	du miel
olive oil	de l’huile d’olive
fair trade clothes	des vêtements issus du commerce équitable
handicrafts	des produits artisanaux
labelled products	des produits labellisés
to promote fair trade	promouvoir le commerce équitable
fair competition	la concurrence loyale
to appeal to sb’s sense of economic justice	faire appel au sens de la justice économique de qn
to combat unfair trade rules	combattre des règles commerciales inéquitables
to challenge the dominant system	défier le système dominant
to create a fairer world	créer un monde plus équitable
to share the benefits of trade more equally	répartir les bénéfices du commerce plus équitablement
to support small producers	soutenir les petits producteurs
to save a farmer from bankruptcy	sauver un paysan de la ruine
to stop exploiting farmers	arrêter d’exploiter les paysans
to give farmers decent working conditions	donner aux paysans des conditions de travail décentes
to pay a guaranteed price	payer un prix minimum garanti
to mitigate losses	atténuer les pertes
to pay a premium above market rates	payer un peu plus que les cours du marché
to bypass multinationals	court-circuiter les multinationales
to cut out the middleman	éliminer les intermédiaires
to benefit from fair trade	bénéficier du commerce équitable
to reap the benefits of one’s labour	récolter les fruits de son travail
to earn a decent wage	gagner assez d’argent pour vivre
to go mainstream	se populariser
