an ailing continent	un continent mal en point
a continent in the making	un continent en devenir
a rising continent	un continent qui s’éveille
sub-Saharan Africa	l’Afrique subsaharienne
North Africa	l’Afrique du nord
l’Afrique du nord	être ravagé par la famine
to be riven by conflict	être déchirée par les conflits
to be hard hit by poverty	être durement touchée par la pauvreté
to be drought-stricken	être frappée par la sécheresse
to be decimated by HIV / Aids	être décimée par le sida
to be impoverished by malaria	être appauvrie par le paludisme
to be burdened by unfavourable geography	être handicapée par une géographie défavorable
to be blighted by debt	être minée par les dettes
to suffer from lack of infrastructure	souffrir du manque d’infrastructures
to stamp out / to root out corruption	éradiquer la corruption
corrupt politicians	des hommes politiques corrompus
to get rid of dictators	évincer les dictateurs
to do away with dictatorial regimes	en finir avec les régimes dictatoriaux
to establish democracy	établir la démocratie
to need good governance	avoir besoin d’être bien gouverné
to reduce extreme poverty	réduire la misère
to lift Africa out of poverty	sortir l’Afrique de la pauvreté
to provide financial aid	fournir une aide financière
to supply all Africans with electricity	fournir de l’électricité à tous les Africains
to cancel African countries’ debts	annuler les dettes des pays africains
to put Africa back on track	remettre l’Afrique sur les rails
to help Africa to help itself	aider l’Afrique à s’aider elle-même
to keep one’s promises	tenir ses promesses
to give Africa access to the rich world’s markets	permettre à l’Afrique d’accéder aux marchés du monde riche
to help bridge Africa’s technology gap	aider à combler le fossé technologique de l’Afrique
to fund basic education	financer l’éducation de base
to send many more children to school	scolariser beaucoup plus d’enfants
to move Africa forward	faire avancer l’Afrique
to free itself of western influence	se libérer de l’influence occidentale
to take charge of its own destiny	prendre en main sa propre destinée
