democracy / a democracy	la démocratie / une démocratie
a democrat / democratic	un démocrate / démocratique
a republic / (a) republican	une république / (un) républicain
political propaganda	la propagande politique
a dictatorship / a dictatorial regime	une dictature / un régime dictatorial
a dictator	un dictateur
a military junta	une junte militaire
a tyrant / tyrannical	un tyran / tyrannique
to oppress the people	opprimer le peuple
a coup	un coup d’État
to topple a (totalitarian) regime	renverser un régime (totalitaire)
to oust / to overthrow an oppressor	évincer / renverser un oppresseur
capitalism / (a) capitalist	le capitalisme / (un) capitaliste
socialism / (a) socialist	le socialisme / (un) socialiste
communism / (a) communist	le communisme / (un) communiste
liberalism / (a) liberal	le libéralisme / (un) libéral
conservatism / (a) conservative	le conservatisme / (un) conservateur
to be in power / to come to power	être au pouvoir / arriver au pouvoir
to run a country / a head of state	diriger un pays / un chef d’État
a cabinet meeting	une réunion du Conseil des ministres
a political leader / a politician	un leader / un homme politique
politics / to be in politics	la politique / faire de la politique
(to join) a political party	(adhérer à) un parti politique
the right / a right-winger / right-wing	la droite / qn de droite / de droite
the left / a left-winger / left-wing	la gauche / qn de gauche / de gauche
a party member / a militant	un membre du parti / un militant
a political opponent	un opposant politique
politicking	la politique politicienne
to play politics	faire de la politique politicienne
universal suffrage	le suffrage universel
the right to vote / to vote / a voter	le droit de vote / voter / un électeur
an election campaign	une campagne électorale
to go to the polls	se rendre aux urnes
a constituency	une circonscription électorale
floating voters / undecided voters	les indécis
to count the votes	dépouiller
sleaze / corruption	la corruption
a bribe / to bribe	un pot-de-vin / soudoyer
electoral fraud	la fraude électorale
