a road user	un usager de la route
road signs	la signalisation routière
a car crash / a car accident	un accident de la route
an accident blackspot	un point noir
road casualties	les victimes de la route
road fatalities / traffic fatalities	les accidents mortels
to be critically injured	être grièvement blessé
a head-on collision	une collision frontale
to crash head-on into a car	rentrer de plein fouet dans une voiture
to run into a car	rentrer dans une voiture
a motorway pile-up	un carambolage sur l’autoroute
reckless driving	la délinquance routière
driving behaviour	le comportement au volant
a careless driver	un conducteur imprudent
a roadhog	un chauffard
the Highway Code	le Code de la route
a motoring offence	une infraction au Code de la route
road rage	l’agressivité au volant
to jump the lights / to jump a light	brûler un feu
to cross the white line	franchir la ligne blanche
to give way	céder le passage
to have (the) right of way	avoir la priorité
to fasten one’s seat belt	attacher sa ceinture de sécurité
to overtake a car	dépasser une voiture
an unmarked police car	une voiture banalisée
a speed camera	un radar automatique
a speed trap	un contrôle radar
to exceed the speed limit	dépasser la limitation de vitesse
to get caught speeding	se faire arrêter pour excès de vitesse
a speeding ticket	une amende pour excès de vitesse
to have one’s licence suspended	se faire retirer son permis
a sleeping policeman / a speed bump	un ralentisseur
a speed governor / limiter	un régulateur / un limiteur de vitesse
a governed engine	un moteur bridé
a drink driver / (US) a drunk driver	un conducteur en état d’ébriété
driving under the influence / drink driving / (US) drunk driving	la conduite en état d’ivresse
a breathalyser	un alcootest, un éthylomètre
the blood alcohol limit	l’alcoolémie
to have an MOT	passer au contrôle technique
