the welfare state / the nanny state	l’État providence / l’État nounou
a safety net	un filet de protection (sociale)
National Insurance	la Sécurité sociale (RU)
the National Health Service / the NHS	la Sécurité sociale (au RU : branche assurance maladie)
the “Sécurité Sociale”	la Sécurité sociale (France)
Social Security	la Sécurité sociale (US)
social security / (US) welfare	les prestations sociales
sb on social security / (US) on welfare	qn qui bénéficie de l’aide sociale
minimum social benefits	les minima sociaux (en France)
income support	le RSA (en France)
Universal Credit	l’aide aux personnes à revenu modeste (RU)
employee benefits / fringe benefits	les avantages sociaux
the minimum old-age pension	le minimum vieillesse
the entitlement to benefit	le droit à l’aide sociale
a claimant / a recipient	un ayant droit / un bénéficiaire
the social services	les services d’aide sociale
social work	l’assistance sociale
a social worker	un(e) assistant(e) social(e)
health care	la santé publique
the public health system	le système de santé publique
universal health coverage	la CMU
universal basic income / UBI	le revenu universel
to be entitled to a health insurance	avoir droit à une couverture maladie
to get free medical care	être soigné gratuitement
sickness benefit	les prestations maladie
to take out a private health insurance	prendre une mutuelle
to take out an insurance	s’assurer, prendre une assurance
an old age insurance	une assurance vieillesse
an unemployment insurance	une assurance chômage
compensation for injuries at work	une indemnité d’accident du travail
child benefit / family allowances	les allocations familiales
means-tested benefits	des prestations modulées en fonction des revenus
a single parent’s allowance	une allocation de parent isolé
housing benefit	l’allocation logement, les APL
Jobseeker’s Allowance (JSA)	l’allocation d’aide au retour à l’emploi (l’ARE)
to be on furlough	être en chômage partiel
from the cradle to the grave	du berceau au tombeau
to pick up the pieces	se ressaisir
to fork out	cracher