the death of privacy	la mort de l’intimité, de la vie privée
confidentiality	la confidentialité
intrusion on / into sb’s private life	l’intrusion dans la vie privée de qn
to intrude on / into sb’s private life	s’ingérer dans la vie privée de qn
to infringe on privacy	empiéter sur la vie privée
to violate sb’s privacy	porter atteinte à la vie privée de qn
a snooper	un fouineur
to snoop on sb / to spy on sb	espionner qn
to poke one’s nose into other people’s business	fourrer son nez dans les affaires des autres
CCTV (= closed-circuit television)	la vidéosurveillance
a surveillance society	une société de surveillance
a surveillance state	un État espion
surveillance	la surveillance (policière, militaire)
to observe sb	surveiller qn
surveillance cameras	des caméras de surveillance
to make personal data available to the police	personnelles à la disposition de la police
to intercept the contents of an e-mail	intercepter le contenu d’un courriel
to monitor sb’s e-mails	surveiller les courriels de qn
a database	une base de données
to retain data / to store data	conserver les informations
to extend state surveillance powers	donner à l’État des pouvoirs de surveillance renforcés
special powers	des pouvoirs spéciaux
civil liberties / individual liberties	les libertés individuelles
to restrict civil liberties	restreindre les libertés individuelles
to erode freedoms	rogner les libertés
to compromise privacy	transiger sur la vie privée
for law-enforcement purposes	dans le but de faire appliquer la loi
wire-tapping / phone-tapping	les écoutes téléphoniques
to bug a room	cacher des micros dans une pièce
to protect one’s privacy / intimacy	protéger sa vie privée / son intimité
the right to privacy	le droit à la vie privée
to enforce data protection legislation	faire appliquer la loi sur l’informatique et les libertés
to safeguard privacy from commercial abuse	protéger la vie privée des abus commerciaux
to have nothing to hide	n’avoir rien à cacher
