a boon or a bane?	un bienfait ou un fléau ?
information technology / IT	la technologie de l’information
computer science / computing	l’informatique
a computer engineer / scientist	un informaticien
data processing / word processing	le traitement des données / de texte
a computer buff	un fana d’informatique
a computer geek / a computer nerd	un cinglé d’informatique
digitization / to digitize	la numérisation / numériser
digital technology	la technologie numérique
to have access to the Net	avoir accès à Internet
an Internet service provider = an ISP	un fournisseur d’accès à Internet
wifi / broadband / ADSL	le wifi / le haut débit / l’ADSL
fibre-optic broadband	le très haut débit
an Internet user	un internaute
an Internet junkie	un drogué d’Internet
to surf / to browse the Net	naviguer, surfer sur Internet
(to visit) a website	consulter un site Internet
to log on / to log off	se connecter / se déconnecter
to Google	faire une recherche sur Google
a newsgroup	un forum de discussion
to download a file	télécharger un fichier
a search engine	un moteur de recherche
a (web) browser	un navigateur (internet)
a server / a link	un serveur / un lien
to tweet / to send a tweet	tweeter / envoyer un tweet
a virus / a spam email	un virus / un spam
antivirus software	un antivirus
spyware and malaware	des logiciels espions ou malveillants
a computer hacker / hacking	un pirate informatique / le piratage
to hack into a system	s’introduire dans un système
to crack a code	trouver un code
phishing	l’hameçonnage / le phishing
piracy	le téléchargement illégal
to bridge the digital divide	combler le fossé informatique
a social network(ing site)	un réseau social
the Internet of Things (IoT)	l’Internet des objets (IdO)
connected objects	les objets connectés
wearable computing	l’informatique intégrée aux vêtements
wearable devices / wearables	des dispositifs portables intelligents
