#separator:tab
#html:false
the Department of the Environment	le ministère de l’Environnement
the environment minister	le ministre de l’environnement
an environmental policy	une politique de l’environnement
environmental management	la gestion de l’environnement
the protection / the preservation / the conservation of the environment	la protection de l’environnement
to protect / preserve the environment	protéger / préserver l’environnement
Overshoot Day	le Jour du dépassement
nature conservation	la préservation de la nature
to be environmentally aware	être conscient des problèmes d’environnement
to be concerned about	se sentir concerné par
to advocate sustainable development	prôner le développement durable
to make people aware of a problem	sensibiliser les gens à un problème
to mobilize public opinion	mobiliser l’opinion publique
an awareness campaign	une campagne de sensibilisation
environmental issues / green issues	les questions environnementales
ecology / an ecologist / ecological	l’écologie / un écologiste / écologique
an environmentalist / a conservationist	un défenseur de l’environnement
a tree-hugger	un écolo
an eco-warrior / a green activist / a green campaigner	un défenseur acharné de l’environnement
an environmental group	une association de défense de l’environnement
the Greens	les Verts
to go green	se convertir à l’écologie
to harm the environment / to cause environmental damage	nuire à l’environnement
to be harmful to the environment	être nuisible à l’environnement
to draw on the Earth’s resources	puiser dans les ressources de la Terre
to be heading for disaster	courir au désastre
the environmental impact	l’impact sur l’environnement
environment(ally) friendly / eco-friendly	respectueux de l’environnement
the ‘polluter pays’ principle	le principe du pollueur-payeur
a carbon tax / a green tax	une taxe carbone / une taxe verte
to reduce one’s carbon footprint	réduire son empreinte carbone
the WWF / Friends of the Earth	le WWF / les Amis de la Terre
