the world economy / the global economy	l’économie mondiale
a state-controlled economy	une économie étatisée
a free-market economy	une économie de marché
a mixed economy	une économie mixte
the law of supply and demand	la loi de l’offre et de la demande
economic activity	l’activité économique
to sustain (economic) growth	soutenir la croissance (économique)
economic reform	la réforme économique
an economic policy	une politique économique
to be in crisis	être en crise
an ailing economy	une économie mal en point
economic troubles	des difficultés économiques
economic stagnation / to stagnate	la stagnation économique / stagner
stagflation / slumpflation	la stagflation (inflation + récession)
deflation	la déflation
(double-dip) recession	la récession (à double creux)
the inflation rate	le taux d’inflation
the buying power / purchasing power	le pouvoir d’achat
the living standard	le niveau de vie
to weather a crisis	surmonter une crise
(the) economic recovery	la reprise économique
an economic upturn	un redressement économique
to revive / to restart / /to kick-start / to stimulate / to reflate the economy	relancer l’économie
reflationary measures	des mesures de relance
a recovery plan / a stimulus package	un plan de relance
to get the economy going again	faire redémarrer l’économie
to boost the economy	donner du tonus à l’économie
an upswing in economic growth	une embellie économique
a turnaround in the market	un redressement du marché
the budget deficit	le déficit budgétaire
budget cuts	des restrictions budgétaires
public spending cuts	la réduction des dépenses publiques
consumer demand	la demande de consommation
consumer confidence	la confiance des consommateurs
to cut / raise interest rates	baisser / augmenter les taux d’intérêt
the GDP (the gross domestic product)	le PIB (le produit intérieur brut)
austerity measures	des mesures d’austérité, la rigueur
