work / to be at work	le travail / être au travail
the workplace	le lieu de travail
labour legislation / labour law(s)	le Code du travail
employment / full employment	l’emploi / le plein-emploi
the workforce / the labour force	la main-d’œuvre
to work in shifts	faire les trois-huit
a blue-collar worker	un travailleur manuel
an unskilled worker	un ouvrier non qualifié, un OS
a white-collar worker	un employé de bureau
a temp	un intérimaire
to be self-employed	travailler à son compte
working conditions	les conditions de travail
working hours	les horaires de travail
a working day / (US) a work day	une journée de travail
the 35-hour working week / (US) work week	la semaine de 35 heures
the reduction in the working week	la réduction du temps de travail
to work overtime / to do overtime	faire des heures supplémentaires
absenteeism	l’absentéisme
stress-related work	le stress (lié) au travail
to take a career break	prendre une année sabbatique
a part-time worker / a part timer	un travailleur à mi-temps
the staff turnover	le renouvellement du personnel
job security	la sécurité de l’emploi
job insecurity	la précarité de l’emploi
a stable job / an insecure job	un emploi stable / un emploi précaire
job prospects	des perspectives d’emploi
a career track	un plan de carrière
job satisfaction	la satisfaction au travail
a fixed-term contract	un CDD
a(n) permanent / open-ended contract	un CDI
on-the-job training	la formation sur le tas
a civil servant / a state employee	un fonctionnaire
a senior civil servant	un haut fonctionnaire
the civil service	la fonction publique
the public sector / the private sector	le secteur public / le secteur privé
a low-paid job	un emploi peu rémunéré
a highly-paid job	un emploi bien rémunéré
a responsible job / a top job	un poste à responsabilités
lifetime employment	l'emploi à vie 
in a technologically oriented society	où la technologie prime 
at least	au moins 
be willing to	être disposé 
industrialists	industriels
a probationary periode	une période d'essai 
to hire	embaucher 
to fire	débaucher 
overwork	surmenage 
workaholics	les bourreaux de travail