a plastic bag / bottle	un sac / une bouteille en plastique
a plastic pellet	une boulette de plastique
the plastic-bag industry	l’industrie du sac plastique
the polythene industry	l’industrie du polyéthylène
polystyrene / PVC	du polystyrène / du PVC
plastic foam	de la mousse (de) plastique
clingfilm	du film plastique, du Scellofrais
to block / to clog drains	boucher les égouts
to worsen the effects of floods	aggraver les effets des inondations
to be a threat to the environment	être une menace pour l’environnement
environmental irresponsibility	l’irresponsabilité environnementale
to drift on the surface of the water	dériver à la surface de l’eau
to hang around in the environment	traîner dans la nature
to be strewn around the streets / to litter the streets	joncher les rues
to bluster around the streets	voltiger dans les rues
to be stuck in the branches of trees	être collé dans les branches des arbres
to flap in trees	claquer au vent dans les arbres
to ravage the environment	ruiner l’environnement
to scar the landscape	défigurer le paysage
to spoil the view	gâcher la vue
visual pollution	la pollution visuelle
to dispose of / to throw away a bag	jeter un sac
to bin a bag	mettre un sac à la poubelle
the durability / the life expectancy	la durée de vie (d’un sac)
non-biodegradable	qui n’est pas biodégradable
to break down / to decompose	se désagréger
to biodegrade	être biodégradable
a 100% degradable bag	un sac 100 % biodégradable
to declare war on plastic	déclarer la guerre au plastique
to fight against overpackaging	lutter contre le suremballage
to charge a customer for a bag	faire payer un sac à un client
a reusable bag	un sac réutilisable
to encourage people to reuse a bag	inciter les gens à réutiliser un sac
to recycle a bag	recycler un sac
to slash plastic bag usage by 60%	réduire l’utilisation des sacs plastique de 60 %
to take drastic action	prendre des mesures draconiennes
