the People’s Republic of China	la République populaire de Chine
the Chinese / a Chinese	les Chinois / un Chinois
the world’s most populated country	le pays le plus peuplé du monde
to speak Chinese	parler chinois
Mao’s statue	la statue de Mao
the Great Leap Forward	le Grand Bond en avant
a political opponent	un adversaire politique
to abolish its re-education camps	abolir ses camps de rééducation
a party official	un responsable du parti
today’s China	la Chine d’aujourd’hui
China’s military potential	le potentiel militaire de la Chine
to stand tall in the world	être un grand de ce monde
to be a major space power	être une puissance spatiale majeure
to set the pace in several scientific fields	donner le la dans plusieurs domaines scientifiques
a huge consumer market	un vaste marché de consommateurs
China is modernizing	la Chine se modernise
to modernize the economy	moderniser l’économie
to make giant strides	avancer à pas de géant
unprecedented economic growth	une croissance économique sans précédent
the world’s largest exporter	le premier exportateur mondial
the world’s largest car manufacturer	le premier constructeur automobile mondial
the world’s cheapest labour force	la main-d’œuvre la moins chère du monde
the workshop of the world	l’atelier du monde
to innovate	innover
to get materialistic	devenir matérialiste
to be materially obsessed	être obsédé par le matérialisme
to be bursting with consumers	regorger de consommateurs
to become westernized	s’occidentaliser
China’s westernization	l’occidentalisation de la Chine
to be heading towards capitalism	être en route pour le capitalisme
rural China	la Chine rurale
China’s urbanization	l’urbanisation de la Chine
the world’s largest polluter	le premier pollueur mondial
lead pollution	la pollution par le plomb
to scrap its one-child policy	abandonner sa politique de l’enfant unique
