food waste	le gaspillage alimentaire, les déchets alimentaires
food loss	les denrées perdues
to toss food into the bin	jeter de la nourriture à la poubelle
to respect food	respecter la nourriture
to cut food waste	réduire le gaspillage alimentaire
to halve global food waste	diviser par deux le gaspillage alimentaire mondial
to take action to reduce waste	agir pour réduire le gaspillage
to educate people about the problem / to raise awareness about the problem	sensibiliser les gens au problème
a waster of food	un gaspilleur de nourriture
a food-wasting country	un pays qui gaspille la nourriture
foods	des produits alimentaires
a food bank	une banque alimentaire
a charity	une organisation caritative
World Food Day	la Journée mondiale contre la faim
the FAO (the Food and Agricultural Organisation)	l’Organisation (de l’ONU) pour l’alimentation et l’agriculture
the world’s food supply	les ressources alimentaires mondiales
a zero-wastage policy	une politique de gaspillage zéro
sustainable food systems	des systèmes alimentaires durables
to donate unsold food	donner la nourriture invendue
to sell their surplus food at reduced prices	vendre leur surplus de nourriture à prix réduit
not to over-order (in a restaurant)	ne pas trop commander
not to over-buy (in shops)	ne pas trop acheter
to stick to one’s shopping list	s’en tenir à sa liste de courses
to store food wisely	stocker la nourriture intelligemment
to use leftovers	utiliser les restes
to pay attention to expiry dates	faire attention aux dates de péremption
to sell ugly fruit(s) and vegetables	vendre les fruits et légumes abîmés
to support local producers	soutenir les producteurs locaux
to fight against post-harvest food loss	lutter contre les pertes alimentaires après récolte
to reduce loss during transport	limiter les pertes pendant le transport
to use wooden crates (for transport)	utiliser des caisses en bois
