to take drugs / to dope	se doper
a performance-enhancing drug	un (produit) dopant
a banned substance	un produit interdit
steroids	les anabolisants
to take / to use creatine	se doper à la créatine
blood doping	l’autotransfusion
growth hormones	des hormones de croissance
an energy builder / an energy drink	un tonique / une boisson énergisante
testosterone	la testostérone
to increase muscle bulk	augmenter la masse musculaire
to increase stamina	accroître l’endurance
a dietary / nutritional supplement	un complément alimentaire
to cheat / a cheat	tricher / un tricheur
a doping test / a drug(s) test	un contrôle antidopage
to test positive for nandrolone	être contrôlé positif à la nandrolone
to fail a doping test / a drug(s) test	être contrôlé positif
to be stripped of one’s gold medal	être privé de sa médaille d’or
to be banned for life	être suspendu à vie
a repeat offender	un récidiviste
to be disqualified	être disqualifié
a clean / a dirty event	une compétition où les participants ne se dopent pas / se dopent
a drug(s) scandal / a doping scandal	un scandale lié au dopage
doping allegations / doping charges	des accusations de dopage
an injection	une piqûre
a foolproof test	un test infaillible
undetectable drugs	des produits indétectables
random testing	des contrôles inopinés
to take a random test	se soumettre à un contrôle inopiné
an out-of-competition test	un contrôle pendant les périodes d’entraînement
an anti-doping official	un responsable de la lutte anti-dopage
to be nailed / to be caught out	se faire prendre
to have one’s name cleared	être blanchi
to be a target of suspicion	être l’objet de soupçons
to get away with it	passer à travers les mailles du filet
a urine sample	un échantillon d’urine
to eradicate the use of drugs	éradiquer le dopage
to declare war on doping	déclarer la guerre au dopage
