to raise awareness about recycling	sensibiliser au recyclage
to reduce, reuse and recycle	réduire, réutiliser et recycler
the recycling industry	l’industrie du recyclage
a (waste) recycling plant	une usine de recyclage (des déchets)
a recycling scheme	un programme de recyclage
the recyclability of a product	la recyclabilité d’un produit
a high recycling rate	un taux de recyclage élevé
a (non-) recyclable material	un produit (non-) recyclable
to recycle glass / tyres / plastic / cardboard	recycler le verre / les pneus / le plastique / le carton
to recycle green waste	recycler les déchets verts
to reprocess green waste into compost	transformer les déchets verts en compost
the bottle bank	le conteneur pour la collecte du verre usagé
a (non-) returnable bottle	une bouteille (non-) consignée
a refundable deposit	une consigne remboursée
recycled paper	le papier recyclé
to label a recycled product	étiqueter un produit recyclé
waste management	la gestion des déchets
waste disposal / (US) garbage disposal	le traitement des déchets
a waste disposal (unit)	un broyeur à ordures
an incinerator	un incinérateur
a scrap heap	un dépôt de ferraille
to turn sth into a product of higher quality = to upcycle	transformer qch en un produit de meilleure qualité = upcycler
to (re)process / to convert waste	traiter, transformer les déchets
to sort waste	trier les déchets
a sorting facility	un centre de tri
waste sorting / selective sorting / waste separation	le tri sélectif
to be sorted by hand	être trié à la main
a recycling bin	une poubelle de tri sélectif
to reclaim lead from a car battery	récupérer le plomb sur une batterie de voiture
to reclaim mercury from old TVs	récupérer le mercure sur les vieilles télés
to reclaim gold from e-waste	récupérer l’or sur les déchets électroniques
to recycle the concrete of old buildings	recycler le béton des vieux immeubles
