a Brexiter / a leaver	un Brexiter, un partisan du Brexit
an anti-Brexiter / a remainer	un partisan de l’Union européenne
to leave the EU	sortir de l’Union européenne
to remain in the EU	rester dans l’Union européenne
to lose the EU referendum	perdre le référendum sur l’Europe
to get Brexit done	mener le Brexit à son terme
to vote overwhelmingly for in / out	voter massivement pour rester / sortir
to be out of the EU	ne plus être dans l’Union européenne
a day of complete despair for 48% of British people	un jour de désespoir total pour 48 % des Britanniques
a starkly divided nation	une nation fortement divisée
a journey into the unknown	un voyage dans l’inconnu
to face the consequences	assumer les conséquences
Brexit is not going to be a cake walk	le Brexit ne va pas être un long fleuve tranquille
the reality of Brexit is starting to bite	la réalité du Brexit commence à se faire sentir
to take back control	reprendre le contrôle
to be better off than before	s’en sortir mieux qu’avant
the UK-EU post-Brexit trade deal	l’accord commercial post-Brexit entre le RU et l’UE
to exit the single market	sortir du marché unique
tariff-free and quota-free access for both sides	un accès sans droits de douane ni quotas pour les deux partis
reciprocal arrangements	des arrangements réciproques
border checks	des contrôles aux frontières
new procedures at ports	de nouvelles procédures dans les ports
to comply with new regulations	respecter de nouvelles réglementations
to imply a lot of paperwork	impliquer beaucoup de paperasserie
to reduce EU fishing quotas from 2026	réduire les quotas de pêche de l’UE à partir de 2026
to put an end to the Erasmus programme	mettre un terme au programme Erasmus
to need a visa for stays over 90 days	avoir besoin d’un visa pour des séjours de plus de 90 jours
to need a work permit	avoir besoin d’un permis de travail
to be independent of the European Court of Justice	ne plus dépendre de la Cour de justice européenne
