academic standards	les exigences scolaires, le niveau
academic failure	l’échec scolaire
to stream	faire des groupes de niveau
mixed ability classes	des classes hétérogènes
dumbing down	le nivellement par le bas
a boarding school / a boarder	un internat / un interne
to skip school / to play truant	sécher les cours
school violence	la violence scolaire
ragging / (US) hazing	le bizutage
a school dropout	un décrocheur
to drop out of school	abandonner l’école
to be academic / academically able	être doué pour les études
a gifted child	un surdoué
to be a high achiever	avoir de très bons résultats scolaires
to be a low achiever	être en échec scolaire
to be an underachiever	avoir des résultats décevants
the school year / a term	l’année scolaire / un trimestre
the timetable / (US) the schedule	l’emploi du temps
the syllabus	le programme
to move up a class	passer dans la classe supérieure
to repeat a year	redoubler
assessment	l’évaluation
to take / to sit an exam	passer un examen
to pass / to fail an exam	réussir / échouer à un examen
a mock exam	un examen blanc
a competitive exam	un concours
cheating during exams	la triche aux examens
cheat sheets	des antisèches
to swot / to cram	bachoter
an examiner / a candidate	un examinateur / un candidat
a remedial course	des cours de soutien
a refresher course	des cours de recyclage
a crash course	des cours intensifs
a sandwich course	la formation en alternance
to take a course in computing	suivre des cours d’informatique
e-learning / distance learning	l’enseignement à distance
homeschooling / unschooling	l’instruction à domicile
vocational training	la formation professionnelle
