the depopulation crisis 	 la dénatalité, la crise de la natalité
the fall in the birth rate 	 la diminution des naissances
a demographic crisis 	 une crise démographique
an unprecedented decline 	 une baisse sans précédent
to fall by / to shrink by (5%) 	 baisser de, diminuer de (5 %)
a fall in / a decrease in the population 	 une diminution de la population
to fall sharply 	 diminuer fortement
to collapse / to slump 	 s’effondrer
to plummet / to plunge 	 être en chute libre
a baby bust 	 une chute de la natalité
a birth dearth 	 un nombre de naissances insuffisant
the generation replacement rate 	 le taux de remplacement des générations
an ageing population 	 une population vieillissante
to delay giving birth 	 avoir des enfants plus tard
to pursue higher education 	 faire des études supérieures
to opt against giving birth 	 décider de ne pas avoir d’enfants
to be reluctant to have children 	 hésiter à avoir des enfants
to live for oneself 	 vivre pour soi
effective contraceptive devices 	 des moyens de contraception efficaces
to be incompatible with a career 	 être incompatible avec une carrière
the fear of unemployment / the future 	 la peur du chômage / de l’avenir
prohibitive housing costs 	 des coûts du logement prohibitifs
to address the crisis 	 s’attaquer à la crise
a strong birth policy 	 une politique nataliste volontariste
to urge / to encourage people to have more children 	 inciter les gens à avoir plus d’enfants
to take measures / steps 	 prendre des mesures
incentives 	 des mesures incitatives
to promote flexitime 	 promouvoir l’aménagement du temps de travail
to promote long-term employment 	 promouvoir l’emploi pérenne
early schooling 	 la scolarisation précoce
to set up childcare facilities 	 bâtir des crèches
tax breaks 	 des réductions d’impôts
extend maternity / paternity leave 	 allonger les congés de maternité / de paternité
to increase child benefit 	 augmenter les allocations familiales
maternity benefits / maternity pay 	 les allocations (de) maternité
to grow old 	 vieillir
Ever since the advent of the pill 	 Depuis l’avènement de la pilule
rather than 	 plutôt que
through immigration 	 en raison de l’immigration
to roughly 	 à peu près
it should be the other way round 	 ce devrait être l’inverse
least developed countries 	 les pays les moins avancés
nowhere 	 nulle part
voluntary childlessness 	 le fait de ne pas avoir d’enfants par choix