women's liberation	la libération de la femme
a liberated woman	une femme libérée
equality between men and women / gender equality	l'égalité entre les hommes et les femmes
women's status	la condition féminine
a patriarchal society	une société patriarcale
sexism in the workplace	le sexisme sur le lieu de travail
a sexist	un sexiste
sexist attitudes	des comportements sexistes
a male chauvinist	un phallocrate, un macho (pig)
machismo / macho	le machisme / macho (adj.)
a woman hater / a misogynist	un misogyne
to fill the gender gap	combler le fossé hommes-femmes
feminism / a feminist	le féminisme / une féministe
a women's rights activist	un défenseur des droits des femmes
equality of opportunity / equal opportunities	l'égalité des chances
to be on an equal footing with sb	être sur un pied d'égalité avec qqn
the Equal Pay Act	la loi sur l'égalité des salaires
to get equal pay	avoir un salaire égal
wage disparities	des disparités salariales
the pay gap	les écarts de salaires
female wages	les salaires des femmes
to lag behind	être à la traîne (les salaires)
a male preserve	une chasse gardée des hommes
to break down barriers	faire tomber les barrières
to be judged on merit	être jugé au mérite
to compete with men	rivaliser avec les hommes
to make the grade	être à la hauteur
to get on with men	s'entendre avec les hommes
the right to vote / the right to study	le droit de vote / le droit d'étudier
to take part in political life	participer à la vie politique
to get ahead in politics	progresser en politique
gender equality / parity (in politics)	la parité hommes-femmes (en politique)
participation in decision-making	la participation aux décisions
a male-dominated profession	une profession surtout masculine
the double day of women	la double journée des femmes
women's second shift	la deuxième journée des femmes
to help out / to give a hand	donner un coup de main
to pitch in	mettre la main à la pâte
a better time to be	être mieux loties 
Gone are the days	il est révolu le temps où
to fade into the wallpaper	se fondre avec la tapisserie
Women have shown that they matter just as much as men	Les femmes ont montré qu'elles avaient autant d'importance que les hommes
they could measure up to them	ELles pouvaient faire aussi bien qu'eux
to bump their heads on glass ceilings	se heurter à un plafond de verre
to drag their heels	se traîner les pieds
to be fraught with difficulties	être un parcours du combattant
a marker gender imbalance	un déséquilibre flagrant
regarded as second-class citizens	considérées comme des citoyennes de seconde zone
to have come a long way	avoir fait beaucoup du chemin
men would be all the better for it gender equality became a reality	les hommes ne s'en porteraient que mieux si l'égalité des sexes était une réalité
in all fields	dans tous les domaines