a public health emergency	une urgence de santé publique
to pollute	polluer
industrial / chemical pollution	la pollution industrielle / chimique
workplace pollution	la pollution sur le lieu de travail
airplane pollution / aviation pollution	la pollution due aux avions
to use sustainable aviation fuel	utiliser du carburant d’aviation durable
car exhausts / car exhaust fumes / car emissions	les gaz d’échappement
a toxic cloud	un nuage toxique
a pollutant	un polluant
ozone	l’ozone
nitrogen dioxide / nitrogen oxide	le dioxyde / le monoxyde d’azote
sulphur dioxide	le dioxyde de soufre
carbon dioxide / CO2	le gaz carbonique
particulates / particulate matter	les particules fines
fine-particle pollution	la pollution aux particules fines
diesel-related air pollution	la pollution due au gazole
fuel consumption	la consommation de carburant
a pollution warning system	un système d’alerte anti-pollution
to monitor air quality	mesurer la qualité de l’air
an emergency anti-pollution plan	un plan anti-pollution d’urgence
to drive in cities on alternate days	conduire en ville un jour sur deux
to ban cars on odd-even days	instaurer la circulation alternée
to display a Crit’ Air sticker on one’s windscreen	apposer une vignette Crit’ Air sur son pare-brise
to risk a fine	risquer une amende
to ban traffic from cities	interdire la circulation en ville
the grade-three alert	le niveau 3 de pollution
a pollution peak	un pic de pollution
record pollution levels	des niveaux records de pollution
a car-free day	une journée sans voitures
to irritate the respiratory tract	irriter les voies respiratoires
respiratory problems	des problèmes respiratoires
smog-related problems	des problèmes liés au smog
asthma	l’asthme
to breathe	respirer
unbreathable air	de l’air irrespirable
to fight for breath	essayer de respirer
