the city centre / (US) downtown	le centre-ville
inner cities	un quartier déshérité du centre-ville
a city dweller / (US) an urbanite	un citadin
a metropolis / a megalopolis	une métropole / une mégalopole
an urban area	une zone urbaine
to become urbanised	s’urbaniser
a built-up area	une agglomération (urbaine)
a housing estate / a housing development	un lotissement, une cité
a council house / a council flat	un(e) HLM
a tower block / a high rise	une tour (d’habitation)
a high-rise estate	un grand ensemble
a block of flats	un pâté de maisons
a pavement / (US) a sidewalk	un trottoir
a skyscraper	un gratte-ciel
a dormitory town / (US) a bedroom community	une cité-dortoir
rural depopulation	l’exode rural
an industrial estate / (US) an industrial park	une zone industrielle
a residential area	un quartier d’habitation
a town planner	un urbaniste
town planning / city planning	l’urbanisme
a cityscape	un paysage urbain
the layout of a town	la disposition / conception d’une ville
an urban renewal programme	un programme de rénovation urbaine
to renovate / to rehabilitate	rénover, réhabiliter
the renovation / the rehabilitation	la rénovation / la réhabilitation
to pull down a building	démolir un bâtiment
urban sprawl	la périurbanisation
a hot spot / a trouble spot	un quartier chaud
a no-go area	une zone de non-droit
a suburb	une banlieue, un faubourg
a neighbourhood	un quartier
a shopping centre / a shopping precinct	un centre commercial
a (shopping) mall	une galerie marchande
the commuter belt	la grande banlieue
green spaces	les espaces verts
