the old / old people / the elderly	les personnes âgées
an old man / an old lady	un vieil homme / une vieille dame
a senior citizen / a third-ager / a senior (US)	une personne du troisième âge
to grow old / to get old	vieillir
to be getting on in years	prendre de l’âge
the over-70s	les plus de 70 ans
a seventy-year-old man	un septuagénaire
an eighty-year-old man	un octogénaire
a centenarian	un centenaire
to go grey	grisonner
a white-haired man	un homme aux cheveux blancs
to have white hair	avoir les cheveux blancs
to be bald / baldness	être chauve / la calvitie
a wrinkle / a line	une ride
the infirmities of old age	les infirmités de la vieillesse
vulnerable	vulnérable
disabled	handicapé
a Zimmer frame / a walking frame	un déambulateur
a wheelchair	une chaise roulante
weakness / weak / to weaken	la faiblesse / faible / s’affaiblir
illness / sickness	la maladie
to be in good health / in poor health	être en bonne / mauvaise santé
to die of / to die from	mourir de
senility / senile	la sénilité / sénile
to lose one’s memory	perdre la mémoire
memory loss	la perte de mémoire
Alzheimer’s (disease)	la maladie d’Alzheimer
to require special care	nécessiter des soins particuliers
to be bed-ridden	être grabataire
a home for the aged	une maison de retraite
a nursing home / an old people’s home	une maison médicalisée
a care home	un Ehpad
home health care	l’hospitalisation à domicile
geriatrics	la gériatrie
a gerontologist / a geriatrician	un gérontologue
agism / ageism / age discrimination	l’âgisme, le racisme anti-vieux
to be rejected by society	être rejeté par la société
grey power	le pouvoir économique des personnes âgées
