the world's population / world population	la population mondiale
demography	la démographie
a demographer / a population scientist	un démographe
a census	un recensement
to take a census	affectuer un recensement
the forecast	les estimations, les prévisions
world population growth	la croissance démographique mondiale
the population explosion	l'explosion démographique
overpopulation	la surpopulation
to be overpopulated	être surpeuplé
an age pyramide	une pyramide des âges
an age groupe	une tranche d'âge
the birth rate	le taux de natalité
the fertility rate	le taux de fécondité
birth control	le contrôle des naissances
to make contraception available to all women	rendre la contraception accessible à toutes les femmes
the death rate / mortality / the mortality rate	le taux de mortalité
the infant mortality rate	le taux de mortalité infantile
life expectancy	l'esperence de vie
a densely populated area / an area of low population density	une région fortement peuplée
a sparsely populated area / an area of low population density	une région faiblement peuplée
to rise by / to increase by / to grow by 5%	augmenter de 5%
a rise / an increase in world population	une augmentation de la population mondiale
to rise dramatically	augmenter de façon spectaculaire
to soar / to spiral / to skyrocket	augmenter en flèche
to double / to triple or treble	doubler / tripler
to increase fourfold	être multiplié par quatre
to peak at 9 billion	culminer à 9 milliards
the current trend	la tendance actuelle
the reversal of a trend	un renversement de tendance
a baby boom	un baby boom
the baby boomers	les enfants du baby boom
